,13:28607900-28608500,2:25456900-25457400,5:170837300-170837800,total_mapped_reads,total_reads_in_bam,total_reads_in_fastq,unmapped_reads
Sample6_S6,0,0,0,0,1888,1888,1888
Sample776_S776,0,948,0,948,4664,4666,3716
Sample624_S624,0,86,0,86,4330,4330,4244
Sample507_S507,0,3864,0,3864,5450,5462,1586
Sample960_S960,0,2,0,2,5708,5708,5706
Sample174_S174,0,4,0,4,2178,2178,2174
Sample348_S348,0,491,0,491,2917,2918,2426
Sample779_S779,0,665,0,665,60807,60810,60142
Sample172_S172,0,2,0,2,3022,3022,3020
Sample501_S501,0,3765,0,3765,5945,5958,2180
Sample868_S868,0,7292,0,7292,11092,11122,3800
Sample645_S645,0,2036,0,2036,5064,5068,3028
Sample812_S812,0,1104,0,1104,125162,125164,124058
Sample13_S13,0,2,0,2,2628,2630,2626
Sample221_S221,0,1,0,1,1815,1816,1814
Sample392_S392,0,1731,0,1731,5181,5188,3450
Sample513_S513,0,2096,0,2096,3586,3598,1490
Sample934_S934,0,12454,0,12454,15272,15334,2818
Sample347_S347,0,1557,0,1557,3475,3488,1918
Sample635_S635,0,10234,0,10234,12246,12286,2012
Sample438_S438,0,3822,0,3822,6394,6404,2572
Sample152_S152,0,2,0,2,1964,1966,1962
Sample321_S321,0,8,0,8,2578,2578,2570
Sample848_S848,0,454,0,454,4114,4118,3660
Sample76_S76,0,0,0,0,2180,2180,2180
Sample763_S763,0,0,0,0,2420,2420,2420
Sample458_S458,0,602,0,602,3764,3766,3162
Sample908_S908,0,6297,0,6297,9059,9082,2762
Sample699_S699,0,0,0,0,2068,2068,2068
Sample42_S42,0,0,0,0,1820,1820,1820
Sample114_S114,0,63,0,63,2119,2120,2056
Sample405_S405,0,4227,0,4227,6389,6410,2162
Sample671_S671,0,86,0,86,3468,3468,3382
Sample285_S285,0,2,0,2,1378,1378,1376
Sample132_S132,0,3,0,3,2313,2314,2310
Sample486_S486,0,2153,0,2153,4719,4726,2566
Sample34_S34,0,0,0,0,1932,1932,1932
Sample121_S121,0,22,0,22,2116,2118,2094
Sample475_S475,0,763,0,763,4513,4516,3750
Sample667_S667,0,873,0,873,4211,4214,3338
Sample164_S164,0,0,0,0,1726,1726,1726
Sample514_S514,0,17,0,17,1431,1432,1414
Sample596_S596,0,6385,0,6385,8759,8786,2374
Sample696_S696,0,0,0,0,2550,2550,2550
Sample248_S248,0,227,0,227,2489,2492,2262
Sample310_S310,0,118,0,118,2298,2298,2180
Sample130_S130,0,2,0,2,2362,2364,2360
Sample893_S893,0,2246,0,2246,5676,5688,3430
Sample896_S896,0,2343,0,2343,6831,6842,4488
Sample619_S619,0,1877,0,1877,3651,3660,1774
Sample456_S456,0,3458,0,3458,6416,6436,2958
Sample432_S432,0,1966,0,1966,5852,5862,3886
Sample949_S949,0,113,0,113,4999,5002,4886
Sample230_S230,0,860,0,860,2196,2198,1336
Sample328_S328,0,1095,0,1095,3249,3256,2154
Sample57_S57,0,0,0,0,2566,2566,2566
Sample274_S274,0,12,0,12,1372,1372,1360
Sample491_S491,0,314,0,314,3312,3314,2998
Sample398_S398,0,3412,0,3412,5608,5620,2196
Sample295_S295,0,142,0,142,1490,1492,1348
Sample814_S814,0,2472,0,2472,62188,62196,59716
Sample857_S857,0,2799,0,2799,6533,6548,3734
Sample109_S109,0,64,0,64,3296,3296,3232
Sample503_S503,0,1925,0,1925,3745,3754,1820
Sample613_S613,0,1199,0,1199,3907,3912,2708
Sample399_S399,0,416,0,416,3302,3306,2886
Sample119_S119,0,6,0,6,2172,2172,2166
Sample565_S565,0,3504,0,3504,6516,6528,3012
Sample408_S408,0,1246,0,1246,3744,3750,2498
Sample477_S477,0,2201,0,2201,4241,4254,2040
Sample926_S926,0,8480,0,8480,10802,10840,2322
Sample270_S270,0,276,0,276,2330,2332,2054
Sample390_S390,0,3291,0,3291,5541,5556,2250
Sample586_S586,0,1698,0,1698,4284,4294,2586
Sample946_S946,0,2346,0,2346,5800,5810,3454
Sample738_S738,0,0,0,0,2940,2940,2940
Sample188_S188,0,0,0,0,2238,2238,2238
Sample618_S618,0,166,0,166,2514,2514,2348
Sample547_S547,0,1821,0,1821,3817,3826,1996
Sample73_S73,0,0,0,0,1868,1868,1868
Sample625_S625,0,53,0,53,1977,1978,1924
Sample954_S954,0,11595,0,11595,15153,15192,3558
Sample794_S794,0,4456,0,4456,66160,66176,61704
Sample247_S247,0,1922,0,1922,3860,3870,1938
Sample476_S476,0,5635,0,5635,7747,7780,2112
Sample65_S65,0,0,0,0,1898,1898,1898
Sample724_S724,0,0,0,0,4068,4068,4068
Sample528_S528,0,80,0,80,4720,4722,4640
Sample86_S86,0,0,0,0,4680,4680,4680
Sample208_S208,0,1391,0,1391,2701,2706,1310
Sample27_S27,0,0,0,0,1572,1572,1572
Sample26_S26,0,1,0,1,2435,2436,2434
Sample87_S87,0,4236,0,4236,6482,6502,2246
Sample716_S716,0,0,0,0,2422,2422,2422
Sample217_S217,0,1167,0,1167,2947,2952,1780
Sample173_S173,0,0,0,0,2024,2024,2024
Sample150_S150,0,0,0,0,2206,2206,2206
Sample805_S805,0,1515,0,1515,90291,90300,88776
Sample753_S753,0,0,0,0,2066,2066,2066
Sample51_S51,0,313,0,313,1919,1920,1606
Sample633_S633,0,529,0,529,2941,2942,2412
Sample102_S102,0,0,0,0,2520,2520,2520
Sample141_S141,0,11,0,11,1953,1954,1942
Sample641_S641,0,745,0,745,2963,2966,2218
Sample153_S153,0,0,0,0,1794,1794,1794
Sample533_S533,0,4528,0,4528,6538,6560,2010
Sample448_S448,0,37,0,37,2431,2432,2394
Sample769_S769,0,2337,0,2337,5827,5834,3490
Sample531_S531,0,284,0,284,1844,1848,1560
Sample655_S655,0,465,0,465,3789,3790,3324
Sample46_S46,0,0,0,0,2022,2022,2022
Sample302_S302,0,6,0,6,2494,2494,2488
Sample255_S255,0,0,0,0,1610,1610,1610
Sample151_S151,0,0,0,0,2862,2862,2862
Sample517_S517,0,2461,0,2461,4549,4558,2088
Sample21_S21,0,0,0,0,1750,1750,1750
Sample235_S235,0,683,0,683,2933,2938,2250
Sample106_S106,0,4873,0,4873,7597,7622,2724
Sample647_S647,0,2208,0,2208,4562,4570,2354
Sample104_S104,0,47,0,47,2761,2764,2714
Sample697_S697,0,0,0,0,2716,2716,2716
Sample466_S466,0,3358,0,3358,5612,5622,2254
Sample899_S899,0,1032,0,1032,7178,7188,6146
Sample611_S611,0,3346,0,3346,5192,5206,1846
Sample468_S468,0,3039,0,3039,6085,6106,3046
Sample180_S180,0,0,0,0,1986,1986,1986
Sample506_S506,0,2404,0,2404,4554,4564,2150
Sample140_S140,0,3338,0,3338,5460,5476,2122
Sample60_S60,0,0,0,0,1974,1974,1974
Sample634_S634,0,1968,0,1968,4296,4312,2328
Sample651_S651,0,2310,0,2310,5064,5068,2754
Sample291_S291,0,306,0,306,2694,2696,2388
Sample497_S497,0,2573,0,2573,5205,5212,2632
Sample89_S89,0,0,0,0,1720,1720,1720
Sample148_S148,0,1,0,1,1989,1990,1988
Sample918_S918,0,7190,0,7190,9782,9810,2592
Sample283_S283,0,457,0,457,3075,3078,2618
Sample733_S733,0,2,0,2,2598,2598,2596
Sample45_S45,0,4,0,4,1798,1798,1794
Sample287_S287,0,2739,0,2739,4755,4764,2016
Sample474_S474,0,2780,0,2780,4760,4772,1980
Sample249_S249,0,2174,0,2174,3990,3996,1816
Sample79_S79,0,0,0,0,2962,2962,2962
Sample659_S659,0,2426,0,2426,5922,5938,3496
Sample728_S728,0,0,0,0,2466,2466,2466
Sample864_S864,0,1408,0,1408,4838,4844,3430
Sample767_S767,0,0,0,0,2678,2678,2678
Sample666_S666,0,2038,0,2038,4818,4820,2780
Sample418_S418,0,224,0,224,2704,2706,2480
Sample676_S676,0,0,0,0,1704,1704,1704
Sample18_S18,0,0,0,0,2118,2118,2118
Sample914_S914,0,5225,0,5225,9731,9746,4506
Sample428_S428,0,4,0,4,2776,2776,2772
Sample268_S268,0,1561,0,1561,3779,3788,2218
Sample292_S292,0,3069,0,3069,5059,5072,1990
Sample25_S25,0,2,0,2,1732,1732,1730
Sample520_S520,0,1817,0,1817,4219,4224,2402
Sample276_S276,0,0,0,0,1080,1080,1080
Sample19_S19,0,663,0,663,2467,2472,1804
Sample504_S504,0,1620,0,1620,3950,3954,2330
Sample591_S591,0,741,0,741,3263,3264,2522
Sample897_S897,0,986,0,986,4188,4194,3202
Sample170_S170,0,0,0,0,2916,2916,2916
Sample809_S809,0,2798,0,2798,70042,70054,67244
Sample154_S154,0,145,0,145,3063,3064,2918
Sample573_S573,0,2176,0,2176,3948,3960,1772
Sample539_S539,0,64,0,64,2216,2216,2152
Sample952_S952,0,4517,0,4517,7521,7542,3004
Sample383_S383,0,4,0,4,1858,1858,1854
Sample422_S422,0,572,0,572,3198,3198,2626
Sample462_S462,0,2845,0,2845,4279,4290,1434
Sample232_S232,0,982,0,982,3268,3272,2286
Sample417_S417,0,2680,0,2680,5096,5106,2416
Sample817_S817,0,2550,0,2550,51274,51282,48724
Sample607_S607,0,2468,0,2468,4660,4668,2192
Sample158_S158,0,472,0,472,2166,2166,1694
Sample723_S723,0,0,0,0,2888,2888,2888
Sample226_S226,0,222,0,222,2032,2032,1810
Sample53_S53,0,0,0,0,2228,2228,2228
Sample157_S157,0,2,0,2,1986,1986,1984
Sample793_S793,0,1954,0,1954,78544,78552,76590
Sample71_S71,0,2,0,2,2210,2210,2208
Sample407_S407,0,2332,0,2332,4410,4422,2078
Sample67_S67,0,6,0,6,1864,1864,1858
Sample453_S453,0,126,0,126,3038,3038,2912
Sample735_S735,0,0,0,0,2688,2688,2688
Sample97_S97,0,0,0,0,2010,2010,2010
Sample364_S364,0,3501,0,3501,5999,6018,2498
Sample792_S792,0,3574,0,3574,150144,150158,146570
Sample419_S419,0,2089,0,2089,3705,3718,1616
Sample290_S290,0,343,0,343,2365,2366,2022
Sample423_S423,0,2156,0,2156,4046,4056,1890
Sample684_S684,0,0,0,0,2578,2578,2578
Sample590_S590,0,4144,0,4144,7280,7292,3136
Sample388_S388,0,2223,0,2223,4315,4318,2092
Sample637_S637,0,172,0,172,3384,3384,3212
Sample841_S841,0,594,0,594,3706,3708,3112
Sample495_S495,0,82,0,82,3622,3622,3540
Sample862_S862,0,6,0,6,3398,3398,3392
Sample252_S252,0,3176,0,3176,4418,4432,1242
Sample256_S256,0,196,0,196,2232,2232,2036
Sample227_S227,0,313,0,313,2499,2500,2186
Sample93_S93,0,0,0,0,1400,1400,1400
Sample541_S541,0,2830,0,2830,5864,5876,3034
Sample875_S875,0,1108,0,1108,4886,4890,3778
Sample957_S957,0,4,0,4,1898,1898,1894
Sample421_S421,0,3805,0,3805,6149,6164,2344
Sample450_S450,0,8757,0,8757,11161,11190,2404
Sample837_S837,0,615,0,615,81653,81654,81038
Sample452_S452,0,0,0,0,1552,1552,1552
Sample445_S445,0,2952,0,2952,5450,5456,2498
Sample672_S672,0,2587,0,2587,4655,4662,2068
Sample675_S675,0,0,0,0,3484,3484,3484
Sample224_S224,0,3040,0,3040,4536,4550,1496
Sample706_S706,0,0,0,0,3960,3960,3960
Sample584_S584,0,3263,0,3263,6799,6812,3536
Sample598_S598,0,857,0,857,2577,2578,1720
Sample822_S822,0,2697,0,2697,64927,64944,62230
Sample436_S436,0,2492,0,2492,4834,4846,2342
Sample867_S867,0,4054,0,4054,9430,9448,5376
Sample884_S884,0,6690,0,6690,12946,12972,6256
Sample821_S821,0,377,0,377,107203,107204,106826
Sample895_S895,0,2702,0,2702,7676,7692,4974
Sample944_S944,0,439,0,439,5513,5514,5074
Sample500_S500,0,3760,0,3760,6234,6250,2474
Sample110_S110,0,2,0,2,2130,2130,2128
Sample263_S263,0,207,0,207,2889,2890,2682
Sample516_S516,0,342,0,342,2786,2788,2444
Sample355_S355,0,6312,0,6312,8316,8354,2004
Sample877_S877,0,321,0,321,5111,5112,4790
Sample649_S649,0,44,0,44,2726,2726,2682
Sample798_S798,0,3015,0,3015,85819,85834,82804
Sample124_S124,0,477,0,477,2971,2972,2494
Sample479_S479,0,2315,0,2315,5301,5312,2986
Sample758_S758,0,0,0,0,1676,1676,1676
Sample690_S690,0,0,0,0,3080,3080,3080
Sample685_S685,0,0,0,0,2800,2800,2800
Sample199_S199,0,1389,0,1389,3375,3378,1986
Sample869_S869,0,5874,0,5874,9852,9872,3978
Sample238_S238,0,4,0,4,1802,1802,1798
Sample37_S37,0,7131,0,7131,8955,8984,1824
Sample354_S354,0,442,0,442,2322,2324,1880
Sample498_S498,0,4842,0,4842,7382,7400,2540
Sample117_S117,0,276,0,276,2916,2918,2640
Sample861_S861,0,710,0,710,87512,87518,86802
Sample713_S713,0,0,0,0,2818,2818,2818
Sample393_S393,0,80,0,80,3002,3002,2922
Sample662_S662,0,412,0,412,2636,2636,2224
Sample636_S636,0,223,0,223,2929,2930,2706
Sample480_S480,0,3678,0,3678,5734,5738,2056
Sample325_S325,0,1412,0,1412,3902,3908,2490
Sample8_S8,0,0,0,0,2348,2348,2348
Sample105_S105,0,0,0,0,2222,2222,2222
Sample540_S540,0,237,0,237,2387,2390,2150
Sample815_S815,0,2602,0,2602,117504,117516,114902
Sample469_S469,0,2555,0,2555,5741,5756,3186
Sample601_S601,0,3900,0,3900,6038,6048,2138
Sample568_S568,0,3185,0,3185,5729,5740,2544
Sample396_S396,0,1624,0,1624,4090,4092,2466
Sample509_S509,0,3689,0,3689,6417,6428,2728
Sample732_S732,0,0,0,0,3342,3342,3342
Sample522_S522,0,2,0,2,1808,1808,1806
Sample557_S557,0,1392,0,1392,3826,3830,2434
Sample904_S904,0,2557,0,2557,5499,5508,2942
Sample464_S464,0,2113,0,2113,5417,5428,3304
Sample187_S187,0,18,0,18,2430,2430,2412
Sample434_S434,0,775,0,775,3967,3968,3192
Sample1_S1,0,0,0,0,1254,1254,1254
Sample720_S720,0,0,0,0,2570,2570,2570
Sample242_S242,0,1024,0,1024,3002,3006,1978
Sample431_S431,0,2566,0,2566,5256,5268,2690
Sample220_S220,0,4,0,4,1126,1126,1122
Sample602_S602,0,1951,0,1951,4245,4250,2294
Sample323_S323,0,232,0,232,2532,2534,2300
Sample576_S576,0,3211,0,3211,5187,5196,1976
Sample700_S700,0,20,0,20,2584,2584,2564
Sample5_S5,0,1,0,1,1623,1624,1622
Sample543_S543,0,72,0,72,2450,2450,2378
Sample488_S488,0,7127,0,7127,9567,9596,2440
Sample629_S629,0,46,0,46,2994,2994,2948
Sample229_S229,0,273,0,273,1721,1722,1448
Sample827_S827,0,6444,0,6444,86962,86994,80518
Sample338_S338,0,1231,0,1231,3955,3960,2724
Sample774_S774,0,1892,0,1892,5396,5402,3504
Sample642_S642,0,704,0,704,2930,2932,2226
Sample648_S648,0,732,0,732,3890,3896,3158
Sample167_S167,0,0,0,0,3036,3036,3036
Sample712_S712,0,0,0,0,2662,2662,2662
Sample581_S581,0,1267,0,1267,4671,4678,3404
Sample782_S782,0,2470,0,2470,93170,93180,90700
Sample686_S686,0,2683,0,2683,5165,5176,2482
Sample561_S561,0,3050,0,3050,4662,4678,1612
Sample211_S211,0,6,0,6,1506,1506,1500
Sample331_S331,0,142,0,142,2146,2148,2004
Sample404_S404,0,1501,0,1501,4493,4494,2992
Sample939_S939,0,7478,0,7478,11112,11138,3634
Sample577_S577,0,3261,0,3261,5629,5644,2368
Sample95_S95,0,2,0,2,2350,2350,2348
Sample826_S826,0,814,0,814,65160,65166,64346
Sample536_S536,0,58,0,58,2564,2564,2506
Sample842_S842,0,214,0,214,59828,59828,59614
Sample17_S17,0,0,0,0,1680,1680,1680
Sample664_S664,0,2641,0,2641,4813,4824,2172
Sample643_S643,0,130,0,130,1546,1546,1416
Sample901_S901,0,3982,0,3982,8200,8210,4218
Sample851_S851,0,863,0,863,63611,63618,62748
Sample32_S32,0,0,0,0,2086,2086,2086
Sample103_S103,0,1,0,1,2067,2068,2066
Sample413_S413,0,3518,0,3518,6012,6026,2494
Sample566_S566,0,3285,0,3285,5549,5562,2264
Sample288_S288,0,1086,0,1086,3094,3102,2008
Sample945_S945,0,196,0,196,3788,3788,3592
Sample913_S913,0,6657,0,6657,10535,10560,3878
Sample552_S552,0,4702,0,4702,7670,7690,2968
Sample911_S911,0,7455,0,7455,10175,10208,2720
Sample346_S346,0,24,0,24,2488,2488,2464
Sample796_S796,0,166,0,166,182008,182008,181842
Sample606_S606,0,2272,0,2272,4658,4668,2386
Sample259_S259,0,2478,0,2478,4512,4524,2034
Sample752_S752,0,0,0,0,3006,3006,3006
Sample627_S627,0,261,0,261,3235,3236,2974
Sample742_S742,0,0,0,0,3200,3200,3200
Sample78_S78,0,0,0,0,1692,1692,1692
Sample847_S847,0,22,0,22,4066,4066,4044
Sample2_S2,0,18,0,18,2050,2050,2032
Sample99_S99,0,7,0,7,2969,2970,2962
Sample90_S90,0,0,0,0,1844,1844,1844
Sample755_S755,0,0,0,0,2628,2628,2628
Sample691_S691,0,0,0,0,1662,1662,1662
Sample622_S622,0,855,0,855,3281,3284,2426
Sample656_S656,0,564,0,564,3662,3666,3098
Sample98_S98,0,23,0,23,2431,2434,2408
Sample39_S39,0,0,0,0,1984,1984,1984
Sample740_S740,0,0,0,0,3442,3442,3442
Sample333_S333,0,86,0,86,3012,3012,2926
Sample894_S894,0,7684,0,7684,12306,12334,4622
Sample378_S378,0,845,0,845,2811,2816,1966
Sample786_S786,0,1504,0,1504,60066,60068,58562
Sample218_S218,0,857,0,857,2903,2906,2046
Sample595_S595,0,1319,0,1319,3697,3706,2378
Sample956_S956,0,1,0,1,3833,3834,3832
Sample349_S349,0,0,0,0,1760,1760,1760
Sample680_S680,0,0,0,0,2906,2906,2906
Sample604_S604,0,4562,0,4562,7060,7080,2498
Sample161_S161,0,1,0,1,1865,1866,1864
Sample340_S340,0,2208,0,2208,4260,4270,2052
Sample367_S367,0,22,0,22,2490,2490,2468
Sample597_S597,0,219,0,219,3587,3588,3368
Sample136_S136,0,0,0,0,2408,2408,2408
Sample885_S885,0,369,0,369,4827,4828,4458
Sample137_S137,0,3,0,3,2361,2362,2358
Sample871_S871,0,108,0,108,4578,4578,4470
Sample834_S834,0,1189,0,1189,66553,66554,65364
Sample550_S550,0,2914,0,2914,6108,6122,3194
Sample430_S430,0,1530,0,1530,4262,4274,2732
Sample855_S855,0,436,0,436,4276,4276,3840
Sample470_S470,0,467,0,467,2043,2046,1576
Sample639_S639,0,4713,0,4713,6883,6904,2170
Sample193_S193,0,4356,0,4356,5992,6016,1636
Sample320_S320,0,1886,0,1886,4724,4728,2838
Sample783_S783,0,4738,0,4738,126622,126646,121884
Sample948_S948,0,4510,0,4510,8818,8838,4308
Sample47_S47,0,0,0,0,2156,2156,2156
Sample485_S485,0,1775,0,1775,4717,4720,2942
Sample178_S178,0,1,0,1,2147,2148,2146
Sample807_S807,0,614,0,614,121362,121366,120748
Sample650_S650,0,745,0,745,3973,3978,3228
Sample658_S658,0,1937,0,1937,4495,4514,2558
Sample499_S499,0,929,0,929,2649,2652,1720
Sample59_S59,0,2,0,2,1474,1474,1472
Sample806_S806,0,4332,0,4332,72108,72128,67776
Sample382_S382,0,1,0,1,2067,2068,2066
Sample315_S315,0,1141,0,1141,3019,3020,1878
Sample549_S549,0,1024,0,1024,3612,3616,2588
Sample951_S951,0,5392,0,5392,9802,9822,4410
Sample725_S725,0,0,0,0,2682,2682,2682
Sample425_S425,0,2093,0,2093,3557,3566,1464
Sample127_S127,0,0,0,0,2722,2722,2722
Sample439_S439,0,2828,0,2828,5336,5342,2508
Sample947_S947,0,543,0,543,4779,4780,4236
Sample264_S264,0,219,0,219,3245,3246,3026
Sample791_S791,0,3196,0,3196,139082,139098,135886
Sample75_S75,0,3214,0,3214,5058,5074,1844
Sample574_S574,0,1990,0,1990,4560,4566,2570
Sample608_S608,0,2070,0,2070,4386,4386,2316
Sample670_S670,0,26,0,26,3190,3190,3164
Sample33_S33,0,0,0,0,1132,1132,1132
Sample943_S943,0,0,0,0,4110,4110,4110
Sample737_S737,0,0,0,0,2870,2870,2870
Sample751_S751,0,0,0,0,3182,3182,3182
Sample825_S825,0,2049,0,2049,3963,3970,1914
Sample493_S493,0,3646,0,3646,6424,6434,2778
Sample526_S526,0,150,0,150,2526,2526,2376
Sample266_S266,0,5438,0,5438,6840,6868,1402
Sample365_S365,0,269,0,269,2595,2596,2326
Sample525_S525,0,67,0,67,2231,2232,2164
Sample374_S374,0,584,0,584,1694,1694,1110
Sample764_S764,0,0,0,0,2570,2570,2570
Sample907_S907,0,3373,0,3373,6873,6884,3500
Sample62_S62,0,0,0,0,2242,2242,2242
Sample195_S195,0,273,0,273,1953,1954,1680
Sample135_S135,0,0,0,0,2376,2376,2376
Sample698_S698,0,0,0,0,3224,3224,3224
Sample41_S41,0,0,0,0,2038,2038,2038
Sample163_S163,0,0,0,0,2030,2030,2030
Sample892_S892,0,6884,0,6884,10776,10804,3892
Sample811_S811,0,2208,0,2208,68454,68462,66246
Sample623_S623,0,2007,0,2007,4955,4964,2948
Sample318_S318,0,189,0,189,2235,2236,2046
Sample545_S545,0,601,0,601,2653,2654,2052
Sample381_S381,0,20,0,20,984,984,964
Sample693_S693,0,26,0,26,2688,2688,2662
Sample797_S797,0,1701,0,1701,75781,75788,74080
Sample762_S762,0,0,0,0,2916,2916,2916
Sample789_S789,0,522,0,522,129768,129772,129246
Sample461_S461,0,3331,0,3331,5491,5508,2160
Sample919_S919,0,10737,0,10737,14213,14254,3476
Sample711_S711,0,0,0,0,2712,2712,2712
Sample219_S219,0,94,0,94,1740,1740,1646
Sample594_S594,0,3178,0,3178,5544,5554,2366
Sample626_S626,0,177,0,177,1615,1616,1438
Sample313_S313,0,616,0,616,3016,3018,2400
Sample863_S863,0,1552,0,1552,5096,5104,3544
Sample950_S950,0,1999,0,1999,4417,4428,2418
Sample912_S912,0,5566,0,5566,8272,8288,2706
Sample554_S554,0,5668,0,5668,7980,7998,2312
Sample184_S184,0,0,0,0,1582,1582,1582
Sample175_S175,0,0,0,0,2040,2040,2040
Sample935_S935,0,568,0,568,4144,4146,3576
Sample300_S300,0,830,0,830,2614,2620,1784
Sample692_S692,0,2,0,2,3396,3396,3394
Sample253_S253,0,7407,0,7407,9441,9480,2034
Sample341_S341,0,0,0,0,3074,3074,3074
Sample736_S736,0,0,0,0,2342,2342,2342
Sample145_S145,0,0,0,0,1778,1778,1778
Sample198_S198,0,583,0,583,2213,2214,1630
Sample744_S744,0,0,0,0,4252,4252,4252
Sample189_S189,0,14,0,14,1702,1702,1688
Sample929_S929,0,4334,0,4334,8440,8454,4106
Sample406_S406,0,1748,0,1748,4104,4112,2356
Sample771_S771,0,1158,0,1158,69050,69052,67892
Sample125_S125,0,0,0,0,2348,2348,2348
Sample881_S881,0,752,0,752,4062,4066,3310
Sample852_S852,0,986,0,986,112422,112432,111436
Sample9_S9,0,6,0,6,1608,1608,1602
Sample246_S246,0,1814,0,1814,4020,4028,2206
Sample518_S518,0,1524,0,1524,3396,3398,1872
Sample710_S710,0,0,0,0,3378,3378,3378
Sample556_S556,0,5054,0,5054,7502,7526,2448
Sample953_S953,0,121,0,121,4061,4062,3940
Sample924_S924,0,2,0,2,3584,3584,3582
Sample588_S588,0,1357,0,1357,3997,4006,2640
Sample116_S116,0,0,0,0,2866,2866,2866
Sample878_S878,0,2117,0,2117,7459,7468,5342
Sample478_S478,0,2501,0,2501,5583,5596,3082
Sample449_S449,0,1403,0,1403,4205,4214,2802
Sample766_S766,0,0,0,0,4106,4106,4106
Sample401_S401,0,360,0,360,3300,3304,2940
Sample223_S223,0,4162,0,4162,7536,7558,3374
Sample58_S58,0,0,0,0,1816,1816,1816
Sample361_S361,0,1247,0,1247,3469,3476,2222
Sample463_S463,0,1006,0,1006,3714,3716,2708
Sample922_S922,0,3247,0,3247,5499,5514,2252
Sample11_S11,0,0,0,0,1648,1648,1648
Sample324_S324,0,148,0,148,2824,2824,2676
Sample747_S747,0,0,0,0,3180,3180,3180
Sample921_S921,0,1905,0,1905,7129,7136,5224
Sample56_S56,0,1,0,1,1891,1892,1890
Sample717_S717,0,2,0,2,3400,3400,3398
Sample665_S665,0,307,0,307,2393,2396,2086
Sample702_S702,0,0,0,0,2650,2650,2650
Sample10_S10,0,0,0,0,2234,2234,2234
Sample560_S560,0,288,0,288,3966,3966,3678
Sample50_S50,0,2211,0,2211,4417,4426,2206
Sample511_S511,0,5585,0,5585,7835,7862,2250
Sample113_S113,0,1,0,1,2811,2812,2810
Sample143_S143,0,0,0,0,2066,2066,2066
Sample617_S617,0,67,0,67,2011,2012,1944
Sample858_S858,0,1544,0,1544,52244,52248,50700
Sample244_S244,0,1701,0,1701,3319,3326,1618
Sample820_S820,0,2869,0,2869,117315,117326,114446
Sample16_S16,0,0,0,0,2448,2448,2448
Sample703_S703,0,0,0,0,2736,2736,2736
Sample284_S284,0,3502,0,3502,5176,5194,1674
Sample414_S414,0,2368,0,2368,4132,4138,1764
Sample925_S925,0,978,0,978,3538,3544,2560
Sample131_S131,0,0,0,0,2042,2042,2042
Sample296_S296,0,22,0,22,3428,3428,3406
Sample644_S644,0,7063,0,7063,9895,9926,2832
Sample730_S730,0,0,0,0,2886,2886,2886
Sample937_S937,0,401,0,401,4001,4002,3600
Sample286_S286,0,227,0,227,2381,2384,2154
Sample38_S38,0,0,0,0,2064,2064,2064
Sample909_S909,0,3495,0,3495,5855,5864,2360
Sample203_S203,0,191,0,191,2087,2088,1896
Sample605_S605,0,1261,0,1261,4513,4516,3252
Sample356_S356,0,1387,0,1387,3773,3776,2386
Sample749_S749,0,0,0,0,3220,3220,3220
Sample859_S859,0,93,0,93,59579,59580,59486
Sample85_S85,0,1,0,1,3085,3086,3084
Sample351_S351,0,15,0,15,2767,2768,2752
Sample567_S567,0,2206,0,2206,4984,4992,2778
Sample508_S508,0,6611,0,6611,8853,8876,2242
Sample360_S360,0,247,0,247,3227,3228,2980
Sample718_S718,0,0,0,0,2608,2608,2608
Sample191_S191,0,1327,0,1327,3179,3186,1852
Sample394_S394,0,2069,0,2069,4467,4474,2398
Sample524_S524,0,2020,0,2020,4720,4728,2700
Sample942_S942,0,8,0,8,3194,3194,3186
Sample159_S159,0,65,0,65,2221,2222,2156
Sample433_S433,0,413,0,413,1637,1640,1224
Sample610_S610,0,1218,0,1218,2732,2736,1514
Sample615_S615,0,956,0,956,2244,2244,1288
Sample938_S938,0,646,0,646,5352,5354,4706
Sample429_S429,0,3289,0,3289,6049,6062,2760
Sample416_S416,0,1136,0,1136,4160,4166,3024
Sample334_S334,0,6,0,6,2844,2844,2838
Sample69_S69,0,0,0,0,2088,2088,2088
Sample204_S204,0,4,0,4,1186,1186,1182
Sample599_S599,0,1130,0,1130,4308,4316,3178
Sample898_S898,0,142,0,142,2004,2004,1862
Sample833_S833,0,1526,0,1526,4354,4362,2828
Sample828_S828,0,220,0,220,145434,145434,145214
Sample750_S750,0,26,0,26,2946,2946,2920
Sample473_S473,0,6006,0,6006,7626,7652,1620
Sample241_S241,0,5468,0,5468,7518,7538,2050
Sample563_S563,0,372,0,372,3640,3640,3268
Sample156_S156,0,0,0,0,2074,2074,2074
Sample709_S709,0,0,0,0,2446,2446,2446
Sample646_S646,0,2933,0,2933,6337,6350,3404
Sample459_S459,0,14,0,14,1886,1888,1872
Sample4_S4,0,0,0,0,2106,2106,2106
Sample68_S68,0,0,0,0,1834,1834,1834
Sample510_S510,0,2493,0,2493,4201,4206,1708
Sample845_S845,0,1153,0,1153,123383,123386,122230
Sample357_S357,0,1030,0,1030,3420,3426,2390
Sample52_S52,0,2,0,2,2434,2434,2432
Sample640_S640,0,94,0,94,2388,2390,2294
Sample754_S754,0,0,0,0,2308,2308,2308
Sample342_S342,0,12,0,12,2410,2410,2398
Sample512_S512,0,1483,0,1483,4399,4404,2916
Sample612_S612,0,1198,0,1198,4016,4022,2818
Sample330_S330,0,32,0,32,2344,2344,2312
Sample579_S579,0,2637,0,2637,5585,5596,2948
Sample933_S933,0,3032,0,3032,6290,6304,3258
Sample271_S271,0,2308,0,2308,5366,5372,3058
Sample931_S931,0,18,0,18,3442,3442,3424
Sample917_S917,0,753,0,753,3765,3770,3012
Sample277_S277,0,4,0,4,1502,1502,1498
Sample147_S147,0,0,0,0,2368,2368,2368
Sample727_S727,0,2,0,2,3248,3248,3246
Sample206_S206,0,3713,0,3713,5247,5264,1534
Sample777_S777,0,213,0,213,85825,85826,85612
Sample96_S96,0,0,0,0,2200,2200,2200
Sample708_S708,0,0,0,0,3022,3022,3022
Sample630_S630,0,141,0,141,3309,3310,3168
Sample688_S688,0,0,0,0,1832,1832,1832
Sample387_S387,0,2733,0,2733,5709,5716,2976
Sample768_S768,0,3517,0,3517,10051,10074,6534
Sample160_S160,0,9,0,9,2431,2432,2422
Sample250_S250,0,4115,0,4115,5843,5862,1728
Sample402_S402,0,1588,0,1588,3800,3804,2212
Sample829_S829,0,836,0,836,115144,115148,114308
Sample587_S587,0,2169,0,2169,4465,4472,2296
Sample804_S804,0,731,0,731,105715,105718,104984
Sample437_S437,0,1376,0,1376,3542,3546,2166
Sample43_S43,0,2,0,2,2332,2332,2330
Sample186_S186,0,46,0,46,1872,1872,1826
Sample108_S108,0,1,0,1,3007,3008,3006
Sample395_S395,0,2254,0,2254,4578,4592,2324
Sample487_S487,0,1367,0,1367,3907,3914,2540
Sample329_S329,0,2,0,2,2410,2410,2408
Sample262_S262,0,10,0,10,1016,1016,1006
Sample830_S830,0,2201,0,2201,5371,5378,3170
Sample415_S415,0,2092,0,2092,4360,4372,2268
Sample7_S7,0,0,0,0,2278,2278,2278
Sample81_S81,0,3,0,3,1717,1718,1714
Sample748_S748,0,0,0,0,3070,3070,3070
Sample472_S472,0,14,0,14,2456,2456,2442
Sample657_S657,0,524,0,524,2028,2030,1504
Sample600_S600,0,2796,0,2796,5172,5190,2376
Sample280_S280,0,254,0,254,2702,2704,2448
Sample183_S183,0,1,0,1,2067,2068,2066
Sample447_S447,0,3548,0,3548,6162,6172,2614
Sample196_S196,0,9265,0,9265,10581,10618,1316
Sample128_S128,0,5,0,5,2637,2640,2632
Sample234_S234,0,55,0,55,1837,1838,1782
Sample546_S546,0,3520,0,3520,5534,5552,2014
Sample620_S620,0,410,0,410,3486,3486,3076
Sample928_S928,0,5280,0,5280,8044,8068,2764
Sample101_S101,0,0,0,0,4616,4616,4616
Sample22_S22,0,0,0,0,1902,1902,1902
Sample307_S307,0,232,0,232,2536,2536,2304
Sample891_S891,0,0,0,0,6216,6216,6216
Sample677_S677,0,0,0,0,3220,3220,3220
Sample94_S94,0,1,0,1,2841,2842,2840
Sample707_S707,0,1,0,1,2429,2430,2428
Sample353_S353,0,520,0,520,2362,2366,1842
Sample123_S123,0,8,0,8,2686,2686,2678
Sample48_S48,0,0,0,0,3112,3112,3112
Sample454_S454,0,4252,0,4252,7090,7106,2838
Sample668_S668,0,3514,0,3514,6086,6102,2572
Sample523_S523,0,662,0,662,3090,3092,2428
Sample177_S177,0,1,0,1,2291,2292,2290
Sample332_S332,0,286,0,286,3168,3168,2882
Sample813_S813,0,432,0,432,107224,107224,106792
Sample111_S111,0,155,0,155,1695,1698,1540
Sample532_S532,0,1808,0,1808,4292,4298,2484
Sample337_S337,0,0,0,0,2122,2122,2122
Sample209_S209,0,935,0,935,3173,3176,2238
Sample682_S682,0,1,0,1,2929,2930,2928
Sample294_S294,0,186,0,186,1876,1876,1690
Sample746_S746,0,0,0,0,2778,2778,2778
Sample923_S923,0,3548,0,3548,5774,5784,2226
Sample775_S775,0,1459,0,1459,4703,4710,3244
Sample49_S49,0,64,0,64,1586,1586,1522
Sample112_S112,0,2,0,2,1918,1918,1916
Sample139_S139,0,0,0,0,1522,1522,1522
Sample149_S149,0,0,0,0,2154,2154,2154
Sample192_S192,0,0,0,0,2034,2034,2034
Sample176_S176,0,143,0,143,2343,2344,2200
Sample426_S426,0,1815,0,1815,3917,3922,2102
Sample778_S778,0,2925,0,2925,76639,76654,73714
Sample652_S652,0,899,0,899,3567,3570,2668
Sample865_S865,0,2364,0,2364,6936,6946,4572
Sample467_S467,0,3580,0,3580,5600,5620,2020
Sample745_S745,0,1,0,1,2773,2774,2772
Sample743_S743,0,0,0,0,2920,2920,2920
Sample879_S879,0,1475,0,1475,4315,4324,2840
Sample455_S455,0,1595,0,1595,4159,4166,2564
Sample679_S679,0,0,0,0,2558,2558,2558
Sample370_S370,0,581,0,581,4453,4454,3872
Sample88_S88,0,2,0,2,2704,2704,2702
Sample142_S142,0,0,0,0,2054,2054,2054
Sample580_S580,0,757,0,757,2669,2672,1912
Sample773_S773,0,2900,0,2900,88812,88822,85912
Sample384_S384,0,1359,0,1359,2729,2736,1370
Sample352_S352,0,44,0,44,2104,2104,2060
Sample24_S24,0,1,0,1,1777,1778,1776
Sample844_S844,0,1964,0,1964,103608,103616,101644
Sample551_S551,0,1626,0,1626,4166,4170,2540
Sample874_S874,0,5387,0,5387,8587,8608,3200
Sample201_S201,0,528,0,528,2696,2696,2168
Sample146_S146,0,6,0,6,2706,2706,2700
Sample350_S350,0,76,0,76,2304,2304,2228
Sample799_S799,0,738,0,738,89200,89204,88462
Sample371_S371,0,368,0,368,1700,1702,1332
Sample704_S704,0,0,0,0,1748,1748,1748
Sample714_S714,0,52,0,52,2716,2716,2664
Sample83_S83,0,62,0,62,2356,2356,2294
Sample860_S860,0,3203,0,3203,125785,125804,122582
Sample823_S823,0,1915,0,1915,112611,112614,110696
Sample182_S182,0,4,0,4,1970,1970,1966
Sample214_S214,0,665,0,665,2311,2316,1646
Sample816_S816,0,150,0,150,83300,83300,83150
Sample582_S582,0,465,0,465,3251,3252,2786
Sample403_S403,0,2199,0,2199,4857,4876,2658
Sample66_S66,0,0,0,0,2030,2030,2030
Sample882_S882,0,16,0,16,4386,4386,4370
Sample910_S910,0,7638,0,7638,10862,10890,3224
Sample380_S380,0,290,0,290,2166,2166,1876
Sample529_S529,0,73,0,73,1731,1732,1658
Sample336_S336,0,410,0,410,2728,2732,2318
Sample660_S660,0,2166,0,2166,4818,4834,2652
Sample293_S293,0,1285,0,1285,3919,3924,2634
Sample317_S317,0,519,0,519,3319,3324,2800
Sample155_S155,0,3,0,3,1765,1766,1762
Sample876_S876,0,7759,0,7759,10599,10644,2840
Sample35_S35,0,91,0,91,2577,2578,2486
Sample734_S734,0,0,0,0,2596,2596,2596
Sample835_S835,0,1243,0,1243,89277,89282,88034
Sample903_S903,0,2815,0,2815,6387,6402,3572
Sample900_S900,0,3,0,3,5717,5718,5714
Sample515_S515,0,3131,0,3131,5479,5494,2348
Sample225_S225,0,102,0,102,2274,2274,2172
Sample144_S144,0,0,0,0,3138,3138,3138
Sample955_S955,0,4063,0,4063,8607,8618,4544
Sample790_S790,0,2747,0,2747,87167,87184,84420
Sample442_S442,0,3048,0,3048,5650,5668,2602
Sample190_S190,0,8,0,8,2416,2416,2408
Sample575_S575,0,947,0,947,3631,3634,2684
Sample14_S14,0,2,0,2,2190,2190,2188
Sample343_S343,0,1,0,1,2581,2582,2580
Sample389_S389,0,4779,0,4779,7403,7426,2624
Sample245_S245,0,34,0,34,2002,2002,1968
Sample559_S559,0,341,0,341,3107,3108,2766
Sample411_S411,0,1388,0,1388,2932,2938,1544
Sample705_S705,0,2,0,2,2282,2282,2280
Sample757_S757,0,0,0,0,3076,3076,3076
Sample273_S273,0,192,0,192,2196,2196,2004
Sample379_S379,0,1693,0,1693,3909,3918,2216
Sample592_S592,0,2049,0,2049,5037,5044,2988
Sample890_S890,0,3430,0,3430,8798,8814,5368
Sample739_S739,0,0,0,0,3346,3346,3346
Sample215_S215,0,139,0,139,2323,2326,2184
Sample870_S870,0,553,0,553,5207,5210,4654
Sample726_S726,0,2,0,2,3518,3518,3516
Sample162_S162,0,0,0,0,2470,2470,2470
Sample297_S297,0,414,0,414,2290,2290,1876
Sample212_S212,0,17626,0,17626,19372,19440,1746
Sample941_S941,0,372,0,372,3824,3826,3452
Sample63_S63,0,0,0,0,2378,2378,2378
Sample674_S674,0,1,0,1,2137,2138,2136
Sample721_S721,0,50,0,50,2420,2420,2370
Sample446_S446,0,3277,0,3277,6099,6116,2822
Sample519_S519,0,30,0,30,2122,2122,2092
Sample272_S272,0,482,0,482,2914,2918,2432
Sample335_S335,0,143,0,143,2579,2580,2436
Sample505_S505,0,1301,0,1301,4031,4040,2730
Sample166_S166,0,105,0,105,2861,2862,2756
Sample795_S795,0,2123,0,2123,101381,101394,99258
Sample84_S84,0,0,0,0,1912,1912,1912
Sample548_S548,0,4253,0,4253,6925,6934,2672
Sample866_S866,0,6933,0,6933,11061,11102,4128
Sample535_S535,0,2436,0,2436,5406,5412,2970
Sample441_S441,0,168,0,168,2574,2574,2406
Sample412_S412,0,3188,0,3188,6068,6078,2880
Sample15_S15,0,962,0,962,4254,4256,3292
Sample305_S305,0,165,0,165,2147,2148,1982
Sample243_S243,0,1640,0,1640,3646,3656,2006
Sample781_S781,0,251,0,251,145985,145986,145734
Sample363_S363,0,3317,0,3317,5281,5292,1964
Sample213_S213,0,26,0,26,1474,1474,1448
Sample386_S386,0,2085,0,2085,4529,4536,2444
Sample661_S661,0,2600,0,2600,5098,5108,2498
Sample555_S555,0,880,0,880,2808,2812,1928
Sample484_S484,0,2301,0,2301,4821,4828,2520
Sample759_S759,0,2,0,2,2282,2282,2280
Sample443_S443,0,3681,0,3681,5721,5738,2040
Sample494_S494,0,2252,0,2252,4608,4622,2356
Sample853_S853,0,181,0,181,115649,115652,115468
Sample233_S233,0,2828,0,2828,4514,4530,1686
Sample502_S502,0,3105,0,3105,5119,5130,2014
Sample260_S260,0,1948,0,1948,3676,3688,1728
Sample808_S808,0,1145,0,1145,93247,93248,92102
Sample282_S282,0,323,0,323,2253,2254,1930
Sample729_S729,0,0,0,0,2264,2264,2264
Sample958_S958,0,0,0,0,5150,5150,5150
Sample306_S306,0,0,0,0,2284,2284,2284
Sample339_S339,0,1,0,1,2197,2198,2196
Sample481_S481,0,30,0,30,2258,2258,2228
Sample843_S843,0,514,0,514,64332,64334,63818
Sample327_S327,0,119,0,119,2701,2702,2582
Sample239_S239,0,79,0,79,2107,2110,2028
Sample538_S538,0,615,0,615,3323,3330,2708
Sample72_S72,0,0,0,0,2178,2178,2178
Sample889_S889,0,6959,0,6959,9679,9712,2720
Sample801_S801,0,2547,0,2547,49223,49232,46676
Sample120_S120,0,0,0,0,1984,1984,1984
Sample362_S362,0,0,0,0,2084,2084,2084
Sample314_S314,0,2,0,2,2610,2610,2608
Sample832_S832,0,1629,0,1629,4971,4976,3342
Sample202_S202,0,3668,0,3668,5414,5432,1746
Sample344_S344,0,2586,0,2586,5566,5576,2980
Sample122_S122,0,4,0,4,2352,2352,2348
Sample222_S222,0,5630,0,5630,7244,7266,1614
Sample465_S465,0,3019,0,3019,5641,5652,2622
Sample303_S303,0,10,0,10,1718,1718,1708
Sample12_S12,0,1,0,1,2001,2002,2000
Sample36_S36,0,0,0,0,1980,1980,1980
Sample940_S940,0,2,0,2,3372,3372,3370
Sample873_S873,0,4861,0,4861,9893,9912,5032
Sample673_S673,0,0,0,0,2058,2058,2058
Sample654_S654,0,383,0,383,2725,2726,2342
Sample553_S553,0,897,0,897,3427,3430,2530
Sample564_S564,0,2132,0,2132,4738,4744,2606
Sample770_S770,0,2144,0,2144,79830,79842,77686
Sample537_S537,0,2300,0,2300,4878,4886,2578
Sample391_S391,0,230,0,230,2960,2960,2730
Sample301_S301,0,17,0,17,1805,1806,1788
Sample616_S616,0,1444,0,1444,4128,4136,2684
Sample719_S719,0,1,0,1,1821,1822,1820
Sample482_S482,0,896,0,896,3486,3488,2590
Sample385_S385,0,1387,0,1387,3653,3656,2266
Sample854_S854,0,189,0,189,2631,2632,2442
Sample31_S31,0,2,0,2,2078,2078,2076
Sample240_S240,0,316,0,316,4068,4068,3752
Sample420_S420,0,2490,0,2490,5252,5268,2762
Sample3_S3,0,2,0,2,2642,2642,2640
Sample55_S55,0,0,0,0,2092,2092,2092
Sample760_S760,0,0,0,0,3298,3298,3298
Sample257_S257,0,486,0,486,2314,2316,1828
Sample609_S609,0,213,0,213,2793,2794,2580
Sample74_S74,0,0,0,0,2448,2448,2448
Sample569_S569,0,1139,0,1139,2903,2910,1764
Sample780_S780,0,3355,0,3355,146373,146386,143018
Sample70_S70,0,0,0,0,2316,2316,2316
Sample927_S927,0,5217,0,5217,8385,8410,3168
Sample683_S683,0,0,0,0,2468,2468,2468
Sample308_S308,0,1696,0,1696,3624,3630,1928
Sample375_S375,0,2,0,2,1766,1766,1764
Sample275_S275,0,287,0,287,2025,2026,1738
Sample261_S261,0,6,0,6,1772,1772,1766
Sample810_S810,0,1586,0,1586,56366,56378,54780
Sample100_S100,0,157,0,157,3303,3304,3146
Sample319_S319,0,3796,0,3796,6174,6200,2378
Sample316_S316,0,1776,0,1776,3968,3976,2192
Sample115_S115,0,64,0,64,2622,2622,2558
Sample765_S765,0,0,0,0,2206,2206,2206
Sample663_S663,0,2420,0,2420,5502,5510,3082
Sample603_S603,0,1836,0,1836,4298,4302,2462
Sample571_S571,0,969,0,969,3719,3722,2750
Sample200_S200,0,1502,0,1502,3028,3032,1526
Sample451_S451,0,3250,0,3250,5308,5320,2058
Sample839_S839,0,815,0,815,4355,4360,3540
Sample920_S920,0,5017,0,5017,7819,7832,2802
Sample880_S880,0,5610,0,5610,10030,10056,4420
Sample638_S638,0,992,0,992,3666,3670,2674
Sample460_S460,0,4351,0,4351,7183,7202,2832
Sample279_S279,0,3051,0,3051,5413,5428,2362
Sample372_S372,0,3758,0,3758,6098,6114,2340
Sample185_S185,0,2,0,2,1946,1946,1944
Sample542_S542,0,2760,0,2760,5236,5246,2476
Sample28_S28,0,0,0,0,1944,1944,1944
Sample572_S572,0,5260,0,5260,7596,7614,2336
Sample64_S64,0,0,0,0,1450,1450,1450
Sample701_S701,0,0,0,0,2178,2178,2178
Sample77_S77,0,0,0,0,1770,1770,1770
Sample756_S756,0,2,0,2,2404,2404,2402
Sample787_S787,0,2438,0,2438,82356,82364,79918
Sample784_S784,0,1969,0,1969,120085,120090,118116
Sample309_S309,0,0,0,0,1306,1306,1306
Sample254_S254,0,285,0,285,2147,2148,1862
Sample444_S444,0,3176,0,3176,5608,5618,2432
Sample171_S171,0,3,0,3,2349,2350,2346
Sample40_S40,0,0,0,0,2814,2814,2814
Sample819_S819,0,3884,0,3884,70456,70472,66572
Sample831_S831,0,2997,0,2997,5663,5684,2666
Sample326_S326,0,10,0,10,2056,2056,2046
Sample20_S20,0,0,0,0,1966,1966,1966
Sample788_S788,0,2189,0,2189,177223,177234,175034
Sample216_S216,0,2,0,2,1538,1538,1536
Sample687_S687,0,0,0,0,3210,3210,3210
Sample397_S397,0,1885,0,1885,4197,4202,2312
Sample236_S236,0,3402,0,3402,5560,5570,2158
Sample850_S850,0,998,0,998,45998,46002,45000
Sample653_S653,0,3027,0,3027,5771,5786,2744
Sample621_S621,0,183,0,183,2575,2578,2392
Sample427_S427,0,836,0,836,2052,2054,1216
Sample251_S251,0,5218,0,5218,6562,6588,1344
Sample289_S289,0,114,0,114,1680,1680,1566
Sample689_S689,0,2,0,2,2308,2308,2306
Sample440_S440,0,993,0,993,3125,3126,2132
Sample838_S838,0,4694,0,4694,9520,9538,4826
Sample849_S849,0,419,0,419,4661,4664,4242
Sample886_S886,0,40,0,40,4590,4590,4550
Sample785_S785,0,1386,0,1386,79368,79372,77982
Sample715_S715,0,0,0,0,1944,1944,1944
Sample133_S133,0,0,0,0,1876,1876,1876
Sample818_S818,0,1886,0,1886,55286,55292,53400
Sample322_S322,0,613,0,613,2967,2970,2354
Sample373_S373,0,2189,0,2189,4351,4356,2162
Sample936_S936,0,20,0,20,3274,3274,3254
Sample836_S836,0,2698,0,2698,192676,192686,189978
Sample298_S298,0,5702,0,5702,6566,6588,864
Sample205_S205,0,497,0,497,2141,2142,1644
Sample278_S278,0,0,0,0,2324,2324,2324
Sample312_S312,0,33,0,33,1905,1906,1872
Sample126_S126,0,0,0,0,2016,2016,2016
Sample269_S269,0,26,0,26,1384,1384,1358
Sample669_S669,0,1020,0,1020,3042,3046,2022
Sample281_S281,0,2612,0,2612,4816,4828,2204
Sample409_S409,0,1352,0,1352,3070,3076,1718
Sample631_S631,0,48,0,48,4210,4210,4162
Sample856_S856,0,1203,0,1203,4157,4162,2954
Sample530_S530,0,46,0,46,2736,2736,2690
Sample694_S694,0,1,0,1,2667,2668,2666
Sample258_S258,0,1400,0,1400,3570,3572,2170
Sample490_S490,0,3368,0,3368,5822,5838,2454
Sample265_S265,0,1664,0,1664,3304,3316,1640
Sample772_S772,0,2774,0,2774,140550,140558,137776
Sample585_S585,0,1286,0,1286,3612,3616,2326
Sample369_S369,0,1875,0,1875,4045,4054,2170
Sample916_S916,0,6693,0,6693,9419,9450,2726
Sample872_S872,0,980,0,980,5900,5906,4920
Sample846_S846,0,2700,0,2700,5528,5542,2828
Sample632_S632,0,527,0,527,2545,2546,2018
Sample169_S169,0,45,0,45,1975,1976,1930
Sample80_S80,0,0,0,0,3334,3334,3334
Sample345_S345,0,86,0,86,2636,2636,2550
Sample358_S358,0,2,0,2,2914,2914,2912
Sample299_S299,0,2215,0,2215,3839,3854,1624
Sample165_S165,0,6,0,6,2482,2482,2476
Sample44_S44,0,0,0,0,2300,2300,2300
Sample366_S366,0,0,0,0,2014,2014,2014
Sample311_S311,0,259,0,259,2669,2670,2410
Sample578_S578,0,1757,0,1757,5313,5322,3556
Sample628_S628,0,10,0,10,1682,1682,1672
Sample377_S377,0,3531,0,3531,5489,5506,1958
Sample902_S902,0,3324,0,3324,7166,7186,3842
Sample197_S197,0,10413,0,10413,12007,12054,1594
Sample534_S534,0,1262,0,1262,3796,3802,2534
Sample800_S800,0,652,0,652,69914,69916,69262
Sample107_S107,0,22350,0,22350,24196,24316,1846
Sample887_S887,0,7617,0,7617,11721,11752,4104
Sample888_S888,0,818,0,818,5208,5214,4390
Sample761_S761,0,0,0,0,2,2,2
Sample527_S527,0,139,0,139,2011,2012,1872
Sample803_S803,0,2172,0,2172,64880,64892,62708
Sample583_S583,0,1501,0,1501,3923,3932,2422
Sample359_S359,0,939,0,939,3415,3420,2476
Sample54_S54,0,0,0,0,2512,2512,2512
Sample457_S457,0,1322,0,1322,4288,4290,2966
Sample30_S30,0,0,0,0,1810,1810,1810
Sample930_S930,0,7909,0,7909,11437,11468,3528
Sample681_S681,0,0,0,0,2630,2630,2630
Sample905_S905,0,16,0,16,4620,4620,4604
Sample424_S424,0,3253,0,3253,5417,5434,2164
Sample471_S471,0,2356,0,2356,4516,4524,2160
Sample492_S492,0,2624,0,2624,4880,4890,2256
Sample731_S731,0,0,0,0,2934,2934,2934
Sample82_S82,0,0,0,0,1922,1922,1922
Sample614_S614,0,2831,0,2831,5359,5370,2528
Sample91_S91,0,4,0,4,2284,2284,2280
Sample489_S489,0,452,0,452,3060,3064,2608
Sample589_S589,0,408,0,408,3060,3060,2652
Sample368_S368,0,1113,0,1113,3797,3806,2684
Sample179_S179,0,0,0,0,2182,2182,2182
Sample722_S722,0,0,0,0,1952,1952,1952
Sample695_S695,0,0,0,0,3338,3338,3338
Sample129_S129,0,2,0,2,2162,2164,2160
Sample593_S593,0,961,0,961,3043,3046,2082
Sample824_S824,0,4022,0,4022,93920,93934,89898
Sample521_S521,0,727,0,727,1823,1824,1096
Sample207_S207,0,90,0,90,1842,1842,1752
Sample181_S181,0,0,0,0,1478,1478,1478
Sample304_S304,0,444,0,444,4470,4470,4026
Sample741_S741,0,0,0,0,3370,3370,3370
Sample932_S932,0,7638,0,7638,9834,9876,2196
Sample92_S92,0,0,0,0,1774,1774,1774
Sample400_S400,0,2183,0,2183,4347,4360,2164
Sample237_S237,0,48,0,48,1748,1748,1700
Sample802_S802,0,1405,0,1405,45087,45088,43682
Sample376_S376,0,44,0,44,1946,1946,1902
Sample959_S959,0,6282,0,6282,16316,16340,10034
Sample168_S168,0,6,0,6,1858,1858,1852
Sample23_S23,0,0,0,0,2650,2650,2650
Sample906_S906,0,0,0,0,5406,5406,5406
Sample138_S138,0,0,0,0,2048,2048,2048
Sample118_S118,0,0,0,0,2122,2122,2122
Sample678_S678,0,0,0,0,2174,2174,2174
Sample29_S29,0,0,0,0,2902,2902,2902
Sample435_S435,0,3848,0,3848,6442,6462,2594
Sample228_S228,0,12985,0,12985,14543,14592,1558
Sample483_S483,0,3882,0,3882,7340,7354,3458
Sample61_S61,0,1,0,1,2219,2220,2218
Sample210_S210,0,2533,0,2533,4213,4222,1680
Sample410_S410,0,2455,0,2455,4689,4704,2234
Sample570_S570,0,2269,0,2269,4389,4398,2120
Sample231_S231,0,10,0,10,2540,2544,2530
Sample883_S883,0,6387,0,6387,11475,11514,5088
Sample562_S562,0,579,0,579,2517,2518,1938
Sample544_S544,0,3442,0,3442,5448,5460,2006
Sample134_S134,0,0,0,0,2246,2246,2246
Sample496_S496,0,1193,0,1193,4275,4278,3082
Sample194_S194,0,886,0,886,2626,2630,1740
Sample840_S840,0,31,0,31,4085,4086,4054
Sample558_S558,0,424,0,424,2770,2772,2346
Sample915_S915,0,2649,0,2649,4987,4998,2338
Sample267_S267,0,192,0,192,2202,2202,2010
contig_mean,0,1414.401042,0,1414.401042,10652.31354,10658.375,9237.9125
contig_median,0,461,0,461,3373.5,3375,2435
contig_sum,0,1357825,0,1357825,10226221,10232040,8868396